文字	读音	字义
	gong第一声	古同“肱”。
	lin第二声	古同“邻”。
	rou第二声	古同“蹂”。
	qu第四声	古同“去”。
	lei第三声	垒土块为墙。
	zhuan第一声	纺砖，古代收丝用的一种器具。
	can第一声	古同“参”。
	qi第二声	古同“齐”。
	guai第二声	古同“”。
	ba第二声	狗跑的样子。
	ruo第四声	古同“若”
	li第四声	古同“吏”。
	zhuo第二声	短，不足：“圣人之思，愚人之思～。”
	sou第三声	古同“叟”。
	chi第三声	口气语，无定义。
	mang第二声	表示不肯之声。老年迟钝
	xuan第一声	古同“喧”，大声呼叫。
	ou第三声	和。
	huo第一声	吐气；吐气声。
	qin第四声	同“吣”。
	dou第一声	嗦，言多而不精练。
	ge第二声	富翁。财富多。
	wen第三声	古同“吻”。
	e第四声	古同“呃”。
	shi第一声	（牛）反刍。
	di第三声	古同“诋”。
	shi第四声	古同“嗜”。
	qi第四声	垂足坐。
	da第二声	呵斥。
	tuo第一声	《大日经》译音用字。
	huo第四声	叫呼。
	qi第四声	附耳私语声。
C	shu第四声	饮。如饮酒。
H	e第四声	小语。
I	xuan第三声	小孩哭泣：“悲愁於邑，不～可止兮。”
N	you第四声	呕吐
O	die第四声	佛教咒语用字
S	hao第四声	多话
V	pou第三声	古同“稹
W	mang第二声	语言杂乱
X	zu第二声	叹词，表示斥责
Y	he第四声	众声
^	ba第一声	鸟叫声
_	mie第一声	古同“咩”
`	lie第四声	鸡鸣
a	sui第一声	古同“鳌保催饮（酒）
b	fu第二声	吹气声
c	han第一声	古同“鼾”
d	chuo第四声	古同“啜”。
哿	ge第三声	表示称许。
e	you第四声	古同“诱”，诱骗。
g	gu第一声	古同“f”。
j	yi第四声	〔呜～〕义同“呜咽”，低声哭泣
r	zao第四声	同“唣”。
u	qi第三声	古同“启”。
	qiang第四声	哭泣不止。
	wu第三声	古同“牾”，背逆；抵触。
	zan第二声	同“咱”。
	sha第四声	古同“歃”，盟誓时用嘴吸取（牲血）。
	xu第三声	吐（唾沫）：“～沫求涓滴。”
	duo第二声	语言无度。
	yan第二声	同“岩”。
	pen第四声	象声词：“……～的一声痛哭起来了。”
	jie第一声	方言，箱子：藤～。皮～。
	zao第四声	古同“噪”。
	hu第四声	呕吐。
	ti第二声	同“啼”。
	he第四声	严酷的样子。
	xie第二声	闭合：“予口张而不能～。”
	ru第四声	中国古代北方部族名。
	wa第一声	吞咽声。
	mo第四声	静，寂静：“饥马盈厩～然，未见刍也。”
	jiao第四声	古书上说的一种乐器，即“大埙”。
	lan第二声	〔～[〕言语烦絮不可解。
	yan第四声	古同“唁”，吊唁。
	jian第一声	古同“艰”。
	zeng第四声	日本地名用字，无实义。
	chai第四声	古人名。
	za第二声	〔嘈～〕古同“嘈杂”，（声音）杂乱而喧闹。
	huo第四声	夸。
	chuo第四声	古同“啜”，吃。
	xiao第一声	古同“嚣”。
	ta第四声	同“”。不咀嚼而咽下。
	la第二声	方言，语气词，相当于“了”：～（他来了）。
	chan第二声	尝。
	xi第一声	叹词：“噫吁～，危乎高哉！”
	pi第三声	大。
	chen第四声	梵语“达浮奔虺疲指布施（僧尼）。
	dan第四声	古同“啖”。
	lu第二声	〔～～〕唤猪声。
	hui第二声	古同“回”。
	yin第一声	古同“因”。
	nin第二声	贤。
	yuan第一声	古同“渊”。
	jiong第三声	古同“住薄
	pian第一声	唾弃和斥责声，相当于“呸”。
	yun第二声	古代土地面积单位，十二顷。
	wei第二声	古同“围”。
	guo第二声	古同“国”。
	ri第四声	古同“日”。
	tai第一声	古同“胎”。
	yin第二声	〔～水〕古水名，上游即今中国内蒙古自治区的乌兰木伦河，下游即今中国陕西省的窟野河。
	han第二声	同“函”。
	ku第一声	〔～G〕蒙古语“库伦”的旧译，指围起来的草场，多用于村镇名。
	pu第三声	古同“圃”。
B	ya第四声	（音乐声）低回。
C	tuan第一声	“图书馆”三字的缩写。
E	tu第二声	古同“图”。
H	hui第四声	圈套：圈～。“我恰待踏折他花套竿，撞出锦～头。”
I	yi第四声	（云气）连接不断。
J	luan第二声	古同“K”。圆 。
	chan第二声	古同“廛”。
	lin第二声	菜畦：“芜菁秀出～。”
	rui第三声	古同“睿”。
	wei第二声	古代祭坛四周的矮墙：“掌设王之社～。”
	yan第二声	〔步～〕长廊，如“曲屋～～。”
	dao第三声	土堡：“今有方纭。”
	xian第四声	坚硬结实的土。
	ye第三声	“野”的讹字。
	yi第四声	道路。
	yi第一声	古同“壹”。
